29 2 42
38 205 200 160 299 146 261 162 102 373 47 370 175 350 167 341 288 356
6 20 23 264 178 121 84 37 38 278 111 247 81 224 40 106 39 314 7 347 179 97 3 333 15 98 297 156 86 41 295 17 61 313 270 169 132
5 381 6 332 117 24 77 108 59 125 149 66 237 155 211 186 96 380 206 233 141 213 290 195 91 199 202 229
40 4
12 351 212 89 379 225 305 14 208 34 235 30 65
7 337 24 94 124 8 64 32 217 176 62 92 45 113 137 158 101 139 50 214 16 135 260 112
14 343 287 329 122 323 103 258 171 348 134 226 294 219 90 164 322 357 242 72 360 346 363 358 21 26 74 143 304 222 196 359 87 339 272 340 133 215
37 231 116 49 271 119 82 238 55
8 201 161 245 318 46 58 150 207 19 163 361 273 35 234 9 191 192
35 157 250 75 34 30
20 2 282 42
39 216 300 303 266 202 105 236
19 104 227 147 241 36 102 47 198 62 152 372 80 79 52
17 20 309 23 178 121 84 37 38 278 111 81 40 106 371 39 7 3 15 177 98 28 302 156 41 267 310 313 61 13 274 99
15 4 1
27 34 30
21 331 168 24 94 342 154 63 8 64 352 176 187 62 92 253 45 113 367 69 286 114 88 252 289 123 152 101 268 138 364 263 246 50 54 16 100 285 135 43 296 85 260 189 112
33 190 70 173 231 116 365 174 311 48 325 218 301 59 119 238 55
28 34 157 30
13 31 220 27 362 319 19 136 259 71 193 44 60 239
31 2 282 42
11 20 23 178 37 38 12 269 111 172 81 110 106 118 39 330 203 3 15 116 113 374 297 156 275 41 173 129 107 17 61 230 33
24 355 24 375 108 59 188 125 148 316 151 327 216 46 249 284 293 277 129 107 181 376 377 195 255 119 229 105 315
22 166 245 46 145 93 19 307
32 4 1
44 328 353 34 280
26 369 312 24 94 154 8 83 49 176 187 321 92 183 113 95 334 88 252 289 204 101 306 214 210 209 16 260 85 112
25 67 291 338 148 55 231 368 317 326 335 238 116 56 173 129 107 174 48 230 9 119 66
43 257
23 144 153 140 183 46 353 93 142 242 244 324
2 2 42
41 130 184 251
45 344
10 281 57 283 184 11
3 20 309 23 178 84 37 38 81 110 159 40 106 118 127 256 39 254 349 3 116 15 302 156 41 182 17 313 13 274 99 33
30 190 117 279 53 185 125 262 223 155 211 62 116 29 292 96 68 283 240 109 202 229 130 221
34 248 243 228 126 73 232 197
1 4 1
18 131 378 29 366 18 265 47 5 115
36 308 64 354 336 276 154 62 43 194 135 189 92 78
42 232
16 180 25 265 345 320
9 170 165 5 298 10 126 154 120 22 128 51
4 5 47 18 76
