29 2 42
38 102 146 160 162 167 175 200 205 261 288 299 341 350 356 370 373 47
6 106 111 121 132 15 156 169 17 178 179 20 224 23 247 264 270 278 295 297 3 313 314 333 347 37 38 39 40 41 61 7 81 84 86 97 98
5 108 117 125 141 149 155 186 195 199 202 206 211 213 229 233 237 24 290 332 380 381 59 6 66 77 91 96
40 4
12 14 208 212 225 235 30 305 34 351 379 65 89
7 101 112 113 124 135 137 139 158 16 176 214 217 24 260 32 337 45 50 62 64 8 92 94
14 103 122 133 134 143 164 171 196 21 215 219 222 226 242 258 26 272 287 294 304 322 323 329 339 340 343 346 348 357 358 359 360 363 72 74 87 90
37 116 119 231 238 271 49 55 82
8 150 161 163 19 191 192 201 207 234 245 273 318 35 361 46 58 9
35 157 250 30 34 75
20 2 282 42
39 105 202 216 236 266 300 303
19 102 104 147 152 198 227 241 36 372 47 52 62 79 80
17 106 111 121 13 15 156 177 178 20 23 267 274 278 28 3 302 309 310 313 37 371 38 39 40 41 61 7 81 84 98 99
15 1 4
27 30 34
21 100 101 112 113 114 123 135 138 152 154 16 168 176 187 189 24 246 252 253 260 263 268 285 286 289 296 331 342 352 364 367 43 45 50 54 62 63 64 69 8 85 88 92 94
33 116 119 173 174 190 218 231 238 301 311 325 365 48 55 59 70
28 157 30 34
13 136 19 193 220 239 259 27 31 319 362 44 60 71
31 2 282 42
11 106 107 110 111 113 116 118 12 129 15 156 17 172 173 178 20 203 23 230 269 275 297 3 33 330 37 374 38 39 41 61 81
24 105 107 108 119 125 129 148 151 181 188 195 216 229 24 249 255 277 284 293 315 316 327 355 375 376 377 46 59
22 145 166 19 245 307 46 93
32 1 4
44 280 328 34 353
26 101 112 113 154 16 176 183 187 204 209 210 214 24 252 260 289 306 312 321 334 369 49 8 83 85 88 92 94 95
25 107 116 119 129 148 173 174 230 231 238 291 317 326 335 338 368 48 55 56 66 67 9
43 257
23 140 142 144 153 183 242 244 324 353 46 93
2 2 42
41 130 184 251
45 344
10 11 184 281 283 57
3 106 110 116 118 127 13 15 156 159 17 178 182 20 23 254 256 274 3 302 309 313 33 349 37 38 39 40 41 81 84 99
30 109 116 117 125 130 155 185 190 202 211 221 223 229 240 262 279 283 29 292 53 62 68 96
34 126 197 228 232 243 248 73
1 1 4
18 115 131 18 265 29 366 378 47 5
36 135 154 189 194 276 308 336 354 43 62 64 78 92
42 232
16 180 25 265 320 345
9 10 120 126 128 154 165 170 22 298 5 51
4 18 47 5 76
